------------------------------
------------------------------
------------------------------
------------------------------
-------11111------------------
------------------------------
11---------------11------11---
0011111111111111100----11001--
0000000000000000000----00000--
0000000000000000000-----00----
0000000000000000000-----0-----
0000000000000000000-----------